111111111111111111111111111
1CCCCCCCCCCCCCCCCCCCCCCCCC1
11111100C0000000PCCCCCCCCC1
1CCCCCCCCCCCCCCCCCCCCCCCCC1
111111CCCCCCCCCCCCCCCCCCCC1
1CCCCCC11111111111111111111
10000001E100000000000000001
111111111111111111111111111