1111111111111111111111111111111111
1E1000000000001C10000C100000000001
1000010100100000001001000000000011
1000010010101010001001000000000011
1P1000000C00C0000000000000000000C1
1111111111111111111111111111111111