11111111111111111111
10000000000000000001
10000000000000000P01
10000011111111111111
100000101C1000000001
1C0000000000000000E1
11111111111111111111